1111111111111
1C000000000C1


1011111100011
1P000E1000001
1111111111111