1111111111111
1C000000000C1
1111111100011
1P000E0000001
1111111111111